11111111111111111111111
10000000000000000000001
1000EC00000000000000001
100000000000000000C0001
10000000000000000000001
10000000000000000000001
1000000P000000000000001
10000000000000C00000001
10000000000000000000001
10000000000000000000001
10000000000000000000001
11111111111111111111111
