111111
110E11
1011C1
10P001
111111
