1111111
10000E1
1000001
10P0001
1000C01
1000001
1111111

	g

  
