111111
100C01
1C0E01
1P0001
110C01
111P01
111111
