111111
1E0P01
1110C1
10C011
1E00C1
111111
