11111
10EC1
11P111
100C1
11111
