111111
1E0C11
1C0001
100P01
1C0001
111111
