11111
10C01
1P001
1C0E1
10CS1
11111
